%%%%%%                              
%%%%%%                              
%%%%%%                              
%%%%%%%                             
%%%%%%%                             
%%%%%%%                             
%%%%%%                              
%%%%%%                              
%%%%%%                              
%%%%%%                              
%%%%%%                           %% 
%%%%%                          %%%% 
%%%%%                         %%%%% 
%%%%%                       %%%%%%% 
%%%%                      %%%%%%%%  
%%%%                     %%%%%%%%%  
%%%%                    %%%%%%%%%   
%%%                     %%%%%%%%    
%%%                    %%%%%%%%     
%%%                    %%%%%%%      
%%                     %%%%%%%  %%  
%%%%                   %%%%%%.  %%  
%%%%%%                %%%%%%%  %%   
%%%%%%                %%%%%%. %%%   
%%%%%%%               %%%%%%  %%%   
%%%%%%%               %%%%%. %%%    
%%%%%%%               %%%%%  %%%    
%%%%%%%              %%%%%% %%%     
%%%%%%%              %%%%%  %%%     
%%%%%%%              %%%%% %%%      
%%%%%%              %%%%%% %%%      
%%%%%%              %%%%%  %%       
%%%%%%             %%%%%% %%%       
%%%%%%             %%%%%% %%        
%%%%%              %%%%%%%%%      % 
%%%%%             %%%%%%%%%%     %% 
%%%%              %%%%%%%%%      %% 
%%%% P            %%%%%%%%%     %%% 
%%%%             %%%%%%%%%%     %%% 
%%%              %%%%%%%%%      %%% 
%%%             %%%%%%%%%%     %%%% 
%%              %%% %%%%%%     %%%% 
%               %%%%%%%%%     %%%%% 
%              %%% %%%%%%     %%%%% 
               %%% %%%%%      %%%%% 
              %%%% %%%%%      %%%%% 
              %%%  %%%%%     %%%%%% 
             %%%% %%%%%      %%%%%% 
             %%%  %%%%%      %%%%%% 
            %%%% %%%%%%      %%%%%% 
            %%% .%%%%%%      %%%%%% 
           %%%%..%%%%%       %%%%%% 
           %%%..%%%%%%        %%%%% 
           %%%..%%%%%%        %%%%% 
          %%% .%%%%%%%          %%% 
          %% ..%%%%%%             % 
          %%  %%%%%%%            %% 
             %%%%%%%%            %% 
            %%%%%%%%             %% 
            %%%%%%%%            %%% 
           %%%%%%%%             %%% 
          %%%%%%%%              %%% 
          %%%%%%               %%%% 
          %%%%%                %%%% 
         %%%%                  %%%% 
          %                   %%%%% 
                              %%%%% 
                              %%%%% 
                              %%%%% 
                              %%%%% 
                             %%%%%% 
                             %%%%%% 
                             %%%%%% 
                              %%%%% 
                              %%%%% 
                                    
